5 5
S 1 9 9 9
9 1 9 9 9
9 1 1 9 9
9 9 1 9 9
9 9 1 1 G
